50
27
13 13 13 13 13 13 13 13 13 13 13 13 13 13 13 13 13 13 13 13 13 13 13 13 13 13 13 13 13 13 13 13 13 13 13 13 13 13 13 13 13 13 13 13 13 13 13 13 13 13 
13 11 11 11 11 11 11 11 11 11 11 11 11 11 11 11 11 11 11 11 11 11 11 11 11 11 11 11 11 11 11 11 11 11 11 11 11 11 11 11 11 11 11 11 11 11 11 11 8  13 
13 5  2  3  0  0  0  0  0  0  0  0  0  1  2  2  2  2  2  3  1  2  2  2  2  2  2  2  2  2  2  2  2  2  3  1  2  2  2  2  2  2  2  2  2  2  2  2  4  13 
13 14 14 7  1  2  2  2  2  2  3  0  0  6  14 14 14 14 14 7  6  14 14 14 14 14 14 14 14 14 14 14 14 14 7  6  14 14 14 14 14 14 14 14 14 14 14 14 14 13 
13 13 13 9  6  14 14 14 14 14 7  0  0  1  13 11 11 11 11 2  4  13 11 11 11 11 11 11 11 11 11 11 11 11 2  4  13 11 11 11 11 11 13 11 11 11 11 11 11 13 
13 13 11 1  4  13 5  11 11 13 5  2  3  8  13 9  0  1  6  14 14 13 9  14 14 14 14 14 14 14 14 14 14 14 14 14 13 9  6  14 7  8  13 9  6  14 7  0  8  13 
13 13 9  6  14 13 14 7  8  13 14 14 7  8  13 9  0  6  14 13 11 11 1  11 11 11 11 11 11 11 11 11 11 11 11 11 11 0  1  13 9  8  13 9  1  13 9  0  8  13 
13 11 0  0  11 13 11 0  0  11 11 11 0  8  13 9  1  4  13 11 6  14 14 14 14 14 14 14 14 14 14 14 7  2  2  2  2  2  4  13 5  2  11 2  4  13 5  3  8  13 
13 0  1  2  4  13 5  2  2  2  2  2  2  4  13 5  6  14 13 9  0  11 11 11 13 11 11 11 11 11 13 13 14 14 14 14 14 14 14 13 14 14 14 14 14 13 14 7  8  13 
13 0  6  14 14 13 14 14 14 14 14 14 14 14 13 14 14 13 13 5  3  6  14 7  13 9  2  1  2  4  13 11 11 11 11 11 11 11 11 11 11 11 11 11 11 11 11 0  8  13 
13 5  0  11 13 11 11 11 11 11 11 11 11 11 11 11 11 11 13 14 7  1  13 9  13 9  14 7  14 14 13 9  6  14 14 7  2  2  2  2  2  2  2  2  2  3  0  1  4  13 
13 14 7  0  11 1  2  2  2  2  2  2  2  2  2  2  2  3  11 13 5  8  13 5  11 1  13 4  13 11 11 6  14 13 13 14 14 14 14 14 14 14 14 14 14 7  0  6  14 13 
13 13 5  2  3  6  14 14 14 14 14 14 14 14 14 14 14 7  8  13 14 4  13 14 7  4  13 14 13 9  2  4  13 11 11 11 11 11 11 11 11 4  13 11 11 1  2  4  13 13 
13 13 14 14 7  0  11 13 13 13 11 11 11 11 11 11 13 14 7  11 13 14 13 13 14 14 13 11 11 6  14 14 13 9  2  2  2  3  0  6  14 14 13 9  0  6  14 14 13 13 
13 11 11 13 5  2  3  11 11 13 5  2  3  0  0  0  11 11 0  0  11 11 11 11 11 11 11 1  2  4  13 11 11 6  14 14 14 7  2  4  13 11 11 1  2  4  13 11 11 13 
13 0  8  13 14 14 7  0  8  13 14 14 7  2  2  2  2  2  2  2  2  2  2  3  0  0  0  6  14 14 13 9  2  4  13 11 11 6  14 14 13 9  0  6  14 14 13 9  0  13 
13 5  2  11 11 13 5  2  3  11 11 13 14 14 14 14 14 14 14 14 14 14 14 7  2  3  1  4  13 11 11 6  14 14 13 9  2  4  13 11 11 1  2  4  13 11 11 2  3  13 
13 14 14 7  8  13 14 14 7  0  0  11 13 11 11 11 11 11 13 11 11 11 13 14 14 7  6  14 13 9  2  4  13 11 11 6  14 14 13 9  0  6  14 14 13 9  6  14 7  13 
13 11 11 0  0  11 11 13 5  2  2  2  11 2  6  14 7  4  13 5  3  0  11 11 13 5  1  11 11 6  14 14 13 9  2  4  13 5  11 2  2  4  13 11 11 6  14 13 9  13 
13 5  2  3  0  0  8  13 14 14 14 14 14 14 14 13 14 14 13 14 7  2  3  8  13 14 14 14 14 14 13 11 11 6  14 14 13 14 14 14 14 14 13 9  2  4  13 11 4  13 
13 14 14 7  0  0  0  11 11 11 11 11 11 11 11 11 11 11 11 13 14 14 7  8  13 11 11 11 11 11 13 9  0  0  11 11 11 11 13 11 11 11 11 6  14 14 13 9  14 13 
13 11 11 0  0  0  0  0  0  0  0  0  0  0  0  0  0  0  0  11 11 13 5  2  11 2  6  14 7  2  11 2  2  2  6  14 7  2  11 2  6  14 7  4  13 11 11 1  11 13 
13 0  1  2  2  3  0  0  1  2  2  3  0  0  1  2  2  3  0  0  8  13 14 14 14 14 14 13 14 14 14 14 14 14 14 13 14 14 14 14 14 13 14 14 13 9  6  14 7  13 
13 0  6  14 14 7  0  0  6  14 14 7  0  0  6  14 14 7  1  2  3  11 11 11 11 11 11 11 11 11 11 11 11 11 11 11 11 11 11 11 11 11 11 11 11 0  0  11 0  13 
13 5  1  11 11 2  2  2  1  11 11 2  2  2  1  11 11 2  6  14 7  2  2  2  2  2  2  2  2  2  2  2  2  2  2  2  2  2  2  2  2  2  2  2  2  2  2  2  4  13 
13 14 14 14 14 14 14 14 14 14 14 14 14 14 14 14 14 14 14 13 14 14 14 14 14 14 14 14 14 14 14 14 14 14 14 14 14 14 14 14 14 14 14 14 14 14 14 14 14 13 
13 11 11 11 11 11 11 11 11 11 11 11 11 11 11 11 11 11 11 11 11 11 11 11 11 11 11 11 11 11 11 11 11 11 11 11 11 11 11 11 11 11 11 11 11 11 11 11 11 13 
