20
15
13 13 13 13 13 13 13 13 13 13 13 13 13 13 13 13 13 13 13 13
13 9  11 11 8  13 9  11 11 11 11 11 13 11 11 11 11 11 11 13
13 5  2  3  8  13 9  0  0  0  0  8  13 9  0  0  0  0  8  13
13 14 14 7  8  13 9  0  1  2  3  10 11 12 0  0  1  2  2  13
13 9  11 0  8  13 9  0  6  14 7  1  2  3  0  0  6  14 14 13
13 9  1  2  4  13 5  3  10 11 12 6  14 7  0  0  10 11 11 13
13 9  6  14 14 13 14 7  0  0  0  10 11 12 0  0  0  0  8  13
13 2  3  11 11 11 11 0  1  2  2  3  0  0  0  0  0  0  8  13
13 14 7  0  0  0  0  0  6  14 14 7  0  1  2  2  3  0  8  13
13 13 2  0  0  0  0  0  10 11 11 12 0  6  14 14 7  0  4  13
13 13 14 7  0  0  0  0  1  2  3  0  0  10 10 11 12 6  14 13
13 11 11 0  0  1  2  3  8  14 5  3  0  0  0  0  0  2  11 13
13 9  0  1  2  6  14 7  8  13 14 5  3  0  0  0  6  14 7  13
13 5  2  4  14 14 13 5  4  13 13 14 5  2  2  2  2  11 2  13
13 14 14 14 13 13 13 14 14 13 13 13 14 14 14 14 14 14 14 13