50
50
13 13 13 13 13 13 13 13 13 13 13 13 13 13 13 13 13 13 13 13 13 13 13 13 13 13 13 13 13 13 13 13 13 13 13 13 13 13 13 13 13 13 13 13 13 13 13 13 13 13 
13 0  0  0  0  0  0  0  0  0  0  0  0  0  0  0  0  0  0  0  0  0  0  0  0  0  0  0  0  0  0  0  0  0  0  0  0  0  0  0  0  0  0  0  0  0  0  0  0  13 
13 2  2  0  0  0  0  0  0  0  0  0  0  1  2  2  2  2  2  0  1  2  2  2  2  2  2  2  2  2  2  2  2  2  0  1  2  2  2  2  2  2  2  2  2  2  2  2  2  13 
13 14 14 7  1  2  2  2  2  2  0  0  0  6  14 14 14 14 14 7  6  14 14 14 14 14 14 14 14 14 14 14 14 14 7  6  14 14 14 14 14 14 14 14 14 14 14 14 14 13 
13 13 13 9  6  14 14 14 14 14 7  0  0  1  13 11 11 11 11 2  1  13 11 11 11 11 11 11 11 11 11 11 11 11 2  1  13 11 11 11 11 11 13 11 11 11 11 11 11 13 
13 13 11 1  1  13 11 11 11 13 9  2  0  8  13 9  0  1  6  14 14 13 9  14 14 14 14 14 14 14 14 14 14 14 14 14 13 9  6  14 7  8  13 9  6  14 7  0  0  13 
13 13 9  6  14 13 14 7  8  13 14 14 7  8  13 9  0  6  14 13 11 11 1  11 11 11 11 11 11 11 11 11 11 11 11 11 11 0  1  13 9  8  13 9  1  13 9  0  0  13 
13 11 0  1  11 13 11 0  0  11 11 11 0  8  13 9  1  1  13 11 6  14 14 14 14 14 14 14 14 14 14 14 7  2  2  2  2  2  8  13 9  2  11 2  8  13 9  0  0  13 
13 0  1  2  8  13 9  2  2  2  2  2  2  8  13 9  6  14 13 9  1  11 11 11 13 11 11 11 11 11 13 13 14 14 14 14 14 14 14 13 14 14 14 14 14 13 14 7  0  13 
13 0  6  14 14 13 14 14 14 14 14 14 14 14 13 14 14 13 13 9  0  6  14 7  13 9  2  1  2  8  13 11 11 11 11 11 11 11 11 11 11 11 11 11 11 11 11 0  0  13 
13 2  1  11 13 11 11 11 11 11 11 11 11 11 11 11 11 11 13 14 7  1  13 9  13 9  14 7  14 14 13 9  6  14 14 7  2  2  2  2  2  2  2  2  2  0  0  1  2  13 
13 14 7  0  11 1  2  2  2  2  2  2  2  2  2  2  2  0  11 13 9  8  13 9  11 1  13 1  13 11 11 6  14 13 13 14 14 14 14 14 14 14 14 14 14 7  0  6  14 13 
13 13 9  2  0  6  14 14 14 14 14 14 14 14 14 14 14 7  8  13 14 7  13 14 7  8  13 14 13 9  2  1  13 11 11 11 11 11 11 11 11 11 13 11 11 1  2  1  13 13 
13 13 14 14 7  1  11 13 13 13 11 11 11 11 11 11 13 14 7  11 13 14 13 13 14 14 13 11 11 6  14 14 13 9  2  2  2  0  0  6  14 14 13 9  0  6  14 14 13 13 
13 11 11 13 9  2  0  11 11 13 9  2  0  0  0  0  11 11 0  0  11 11 11 11 11 11 11 1  2  1  13 11 11 6  14 14 14 7  2  1  13 11 11 1  2  1  13 11 11 13 
13 0  8  13 14 14 7  0  8  13 14 14 7  2  2  2  2  2  2  2  2  2  2  0  0  0  0  6  14 14 13 9  2  1  13 11 11 6  14 14 13 9  0  6  14 14 13 9  0  13 
13 2  2  11 11 13 9  2  0  11 11 13 14 14 14 14 14 14 14 14 14 14 14 7  2  0  1  1  13 11 11 6  14 14 13 9  2  1  13 11 11 1  2  1  13 11 11 2  0  13 
13 14 14 7  8  13 14 14 7  0  0  11 13 11 11 11 11 11 13 11 11 11 13 14 14 7  6  14 13 9  2  1  13 11 11 6  14 14 13 9  0  6  14 14 13 9  6  14 7  13 
13 11 11 0  0  11 11 13 9  2  2  2  11 2  6  14 7  8  13 9  0  0  11 11 13 9  1  11 11 6  14 14 13 9  2  1  13 11 11 2  2  1  13 11 11 6  14 13 9  13 
13 2  2  0  0  0  8  13 14 14 14 14 14 14 14 13 14 14 13 14 7  2  0  8  13 14 14 14 14 14 13 11 11 6  14 14 13 14 14 14 14 14 13 9  2  1  13 11 2  13 
13 14 14 7  0  0  0  11 11 11 11 11 11 11 11 11 11 11 11 13 14 14 7  8  13 11 11 11 11 11 13 9  0  1  11 11 11 11 13 11 11 11 11 6  14 14 13 9  14 13 
13 11 11 0  0  0  0  0  0  0  0  0  0  0  0  0  0  0  0  11 11 13 9  2  11 2  6  14 7  2  11 2  2  2  6  14 7  2  11 2  6  14 7  1  13 11 11 1  11 13 
13 0  1  2  2  0  0  0  1  2  2  0  0  0  1  2  2  0  0  0  8  13 14 14 14 14 14 13 14 14 14 14 14 14 14 13 14 14 14 14 14 13 14 14 13 9  6  14 7  13 
13 0  6  14 14 7  0  0  6  14 14 7  0  0  6  14 14 7  1  2  0  11 11 11 11 11 11 11 11 11 11 11 11 11 11 11 11 11 11 11 11 11 11 11 11 0  1  11 0  13 
13 2  1  11 11 2  2  2  1  11 11 2  2  2  1  11 11 2  6  14 7  2  2  2  2  2  2  2  2  2  2  2  2  2  2  2  2  2  2  2  2  2  2  2  2  2  2  2  2  13 
13 14 14 14 14 14 14 14 14 14 14 14 14 14 14 14 14 14 14 13 14 14 14 14 14 14 14 14 14 14 14 14 14 14 14 14 14 14 14 14 14 14 14 14 14 14 14 14 14 13 
13 11 11 11 11 11 11 11 11 11 11 11 11 11 11 11 11 11 11 11 11 11 11 11 11 11 11 11 11 11 11 11 11 11 11 11 11 11 11 11 11 11 11 11 11 11 11 11 11 13 
13 0  0  0  0  0  0  0  0  0  0  0  0  0  0  0  0  0  0  0  0  0  0  0  0  0  0  0  0  0  0  0  0  0  0  0  0  0  0  0  0  0  0  0  0  0  0  0  0  13 
13 0  0  0  0  0  0  0  0  0  0  0  0  0  0  0  0  0  0  0  0  0  0  0  0  0  0  0  0  0  0  0  0  0  0  0  0  0  0  0  0  0  0  0  0  0  0  0  0  13 
13 0  0  0  0  0  0  0  0  0  0  0  0  0  0  0  0  0  0  0  0  0  0  0  0  0  0  0  0  0  0  0  0  0  0  0  0  0  0  0  0  0  0  0  0  0  0  0  0  13 
13 0  0  0  0  0  0  0  0  0  0  0  0  0  0  0  0  0  0  0  0  0  0  0  0  0  0  0  0  0  0  0  0  0  0  0  0  0  0  0  0  0  0  0  0  0  0  0  0  13 
13 0  0  0  0  0  0  0  0  0  0  0  0  0  0  0  0  0  0  0  0  0  0  0  0  0  0  0  0  0  0  0  0  0  0  0  0  0  0  0  0  0  0  0  0  0  0  0  0  13 
13 0  0  0  0  0  0  0  0  0  0  0  0  0  0  0  0  0  0  0  0  0  0  0  0  0  0  0  0  0  0  0  0  0  0  0  0  0  0  0  0  0  0  0  0  0  0  0  0  13 
13 0  0  0  0  0  0  0  0  0  0  0  0  0  0  0  0  0  0  0  0  0  0  0  0  0  0  0  0  0  0  0  0  0  0  0  0  0  0  0  0  0  0  0  0  0  0  0  0  13 
13 0  0  0  0  0  0  0  0  0  0  0  0  0  0  0  0  0  0  0  0  0  0  0  0  0  0  0  0  0  0  0  0  0  0  0  0  0  0  0  0  0  0  0  0  0  0  0  0  13 
13 0  0  0  0  0  0  0  0  0  0  0  0  0  0  0  0  0  0  0  0  0  0  0  0  0  0  0  0  0  0  0  0  0  0  0  0  0  0  0  0  0  0  0  0  0  0  0  0  13 
13 0  0  0  0  0  0  0  0  0  0  0  0  0  0  0  0  0  0  0  0  0  0  0  0  0  0  0  0  0  0  0  0  0  0  0  0  0  0  0  0  0  0  0  0  0  0  0  0  13 
13 0  0  0  0  0  0  0  0  0  0  0  0  0  0  0  0  0  0  0  0  0  0  0  0  0  0  0  0  0  0  0  0  0  0  0  0  0  0  0  0  0  0  0  0  0  0  0  0  13 
13 0  0  0  0  0  0  0  0  0  0  0  0  0  0  0  0  0  0  0  0  0  0  0  0  0  0  0  0  0  0  0  0  0  0  0  0  0  0  0  0  0  0  0  0  0  0  0  0  13 
13 0  0  0  0  0  0  0  0  0  0  0  0  0  0  0  0  0  0  0  0  0  0  0  0  0  0  0  0  0  0  0  0  0  0  0  0  0  0  0  0  0  0  0  0  0  0  0  0  13 
13 0  0  0  0  0  0  0  0  0  0  0  0  0  0  0  0  0  0  0  0  0  0  0  0  0  0  0  0  0  0  0  0  0  0  0  0  0  0  0  0  0  0  0  0  0  0  0  0  13 
13 0  0  0  0  0  0  0  0  0  0  0  0  0  0  0  0  0  0  0  0  0  0  0  0  0  0  0  0  0  0  0  0  0  0  0  0  0  0  0  0  0  0  0  0  0  0  0  0  13 
13 0  0  0  0  0  0  0  0  0  0  0  0  0  0  0  0  0  0  0  0  0  0  0  0  0  0  0  0  0  0  0  0  0  0  0  0  0  0  0  0  0  0  0  0  0  0  0  0  13 
13 0  0  0  0  0  0  0  0  0  0  0  0  0  0  0  0  0  0  0  0  0  0  0  0  0  0  0  0  0  0  0  0  0  0  0  0  0  0  0  0  0  0  0  0  0  0  0  0  13 
13 0  0  0  0  0  0  0  0  0  0  0  0  0  0  0  0  0  0  0  0  0  0  0  0  0  0  0  0  0  0  0  0  0  0  0  0  0  0  0  0  0  0  0  0  0  0  0  0  13 
13 0  0  0  0  0  0  0  0  0  0  0  0  0  0  0  0  0  0  0  0  0  0  0  0  0  0  0  0  0  0  0  0  0  0  0  0  0  0  0  0  0  0  0  0  0  0  0  0  13 
13 0  0  0  0  0  0  0  0  0  0  0  0  0  0  0  0  0  0  0  0  0  0  0  0  0  0  0  0  0  0  0  0  0  0  0  0  0  0  0  0  0  0  0  0  0  0  0  0  13 
13 0  0  0  0  0  0  0  0  0  0  0  0  0  0  0  0  0  0  0  0  0  0  0  0  0  0  0  0  0  0  0  0  0  0  0  0  0  0  0  0  0  0  0  0  0  0  0  0  13 
13 0  0  0  0  0  0  0  0  0  0  0  0  0  0  0  0  0  0  0  0  0  0  0  0  0  0  0  0  0  0  0  0  0  0  0  0  0  0  0  0  0  0  0  0  0  0  0  0  13 
13 14 14 14 14 14 14 14 14 14 14 14 14 14 14 14 14 14 14 14 14 14 14 14 14 14 14 14 14 14 14 14 14 14 14 14 14 14 14 14 14 14 14 14 14 14 14 14 14 13 
